9 2 2 2 2 2 2 2 5 2 2 2 2 2 2 2 5 2 2 2 2 2 2 2 2 2 2 2 5 2 2 2 2 2 2 2 2 2 5 2 10
1 -1 0 0 0 0 0 0 1 0 0 0 0 0 0 0 1 0 0 0 0 0 0 0 0 0 0 0 1 0 0 0 0 0 0 0 0 0 1 0 1
1 0 9 2 2 2 14 0 1 0 13 0 12 2 2 2 6 0 12 2 5 2 5 2 14 0 13 0 8 2 14 0 9 2 2 2 10 0 1 0 1
1 0 1 0 0 0 0 0 1 0 1 0 0 0 0 0 1 0 0 0 1 0 1 0 0 0 1 0 0 0 0 0 1 0 0 0 1 0 1 0 1
1 0 1 0 12 2 10 0 1 0 4 2 2 2 10 0 8 2 10 0 1 0 1 0 12 2 3 2 5 2 2 2 7 0 13 0 1 0 1 0 1
1 0 1 0 0 0 1 0 1 0 1 0 0 0 1 0 0 0 1 0 1 0 1 0 0 0 0 0 1 0 0 0 0 0 1 0 1 0 1 0 1
1 0 8 2 10 0 8 2 7 0 4 2 14 0 4 2 14 0 1 0 15 0 4 2 2 2 10 0 8 2 10 0 12 2 6 0 15 0 15 0 1
1 0 0 0 1 0 0 0 0 0 1 0 0 0 1 0 0 0 1 0 0 0 1 0 0 0 1 0 0 0 1 0 0 0 1 0 0 0 0 0 1
4 2 10 0 8 2 5 2 2 2 7 0 9 2 7 0 9 2 7 0 9 2 7 0 13 0 8 2 14 0 1 0 9 2 3 2 2 2 2 2 6
1 0 1 0 0 0 1 0 0 0 0 0 1 0 0 0 1 0 0 0 1 0 0 0 1 0 0 0 0 0 1 0 1 0 0 0 0 0 0 0 1
1 0 8 2 14 0 1 0 9 2 10 0 1 0 12 2 7 0 12 2 6 0 12 2 11 2 2 2 5 2 7 0 1 0 9 2 2 2 10 0 1
1 0 0 0 0 0 1 0 1 0 1 0 1 0 0 0 0 0 0 0 1 0 0 0 1 0 0 0 1 0 0 0 1 0 1 0 0 0 1 0 1
1 0 12 2 2 2 7 0 1 0 15 0 8 2 2 2 2 2 5 2 3 2 14 0 1 0 12 2 7 0 9 2 6 0 15 0 13 0 1 0 1
1 0 0 0 0 0 0 0 1 0 0 0 0 0 0 0 0 0 1 0 0 0 0 0 1 0 0 0 0 0 1 0 1 0 0 0 1 0 1 0 1
1 0 9 2 2 2 2 2 3 2 2 2 2 2 2 2 10 0 1 0 12 2 5 2 7 0 12 2 2 2 6 0 4 2 2 2 7 0 1 0 1
1 0 1 0 0 0 0 0 0 0 0 0 0 0 0 0 1 0 1 0 0 0 1 0 0 0 0 0 0 0 1 0 1 0 0 0 0 0 1 0 1
1 0 1 0 12 2 5 2 2 2 2 2 5 2 14 0 1 0 4 2 10 0 8 2 2 2 5 2 14 0 15 0 1 0 9 2 5 2 7 0 1
1 0 1 0 0 0 1 0 0 0 0 0 1 0 0 0 1 0 1 0 1 0 0 0 0 0 1 0 0 0 0 0 1 0 1 0 1 0 0 0 1
4 2 3 2 10 0 8 2 10 0 12 2 6 0 12 2 6 0 15 0 8 2 2 2 10 0 1 0 9 2 2 2 7 0 1 0 1 0 12 2 6
1 0 0 0 1 0 0 0 1 0 0 0 1 0 0 0 1 0 0 0 0 0 0 0 1 0 1 0 1 0 0 0 0 0 1 0 1 0 0 0 1
1 0 13 0 8 2 14 0 1 0 13 0 8 2 10 0 1 0 9  2 2 2 2 2 6 0 8 2 7 0 9 2 2 2 7 0 4 2 14 0 1
1 0 1 0 0 0 0 0 1 0 1 0 0 0 1 0 1 0 1 0 0 0 0 0 1 0 0 0 0 0 1 0 0 0 0 0 1 0 0 0 1
1 0 4 2 2 2 2 2 3 2 3 2 10 0 1 0 1 0 1 0 9 2 10 0 1 0 12 2 5 2 3 2 2 2 14 0 1 0 12 2  6
1 0 1 0 0 0 0 0 0 0 0 0 1 0 1 0 1 0 1 0 1 0 1 0 1 0 0 0 1 0 0 0 0 0 0 0 1 0 0 0 1
1 0 8 2 5 2 14 0 9 2 14 0 15 0 1 0 8 2 7 0 1 0 8 2 11 2 14 0 8 2 14 0 9 2 2 2 3 2 10 0 1
1 0 0 0 1 0 0 0 1 0 0 0 0 0 1 0 0 0 0 0 1 0 0 0 1 0 0 0 0 0 0 0 1 0 0 0 0 0 1 0 1
4 2 10 0 1 0 9 2 7 0 12 2 5 2 3 2 2 2 2 2 7 0 13 0 8 2 2 2 10 0 9 2 7 0 9 2 14 0 1 0 1
1 0 1 0 1 0 1 0 0 0 0 0 1 0 0 0 0 0 0 0 0 0 1 0 0 0 0 0 1 0 1 0 0 0 1 0 0 0 1 0 1
1 0 1 0 1 0 8 2 5 2 2 2 7 0 9 2 2 2 5 2 10 0 8 2 5 2 10 0 8 2 7 0 9 2 6 0 12 2 7 0 1
1 0 1 0 1 0 0 0 1 0 0 0 0 0 1 0 0 0 1 0 1 0 0 0 1 0 1 0 0 0 0 0 1 0 1 0 0 0 0 0 1
1 0 1 0 8 2 10 0 15 0 9 2 2 2 7 0 13 0 1 0 4 2 14 0 1 0 8 2 2 2 2 2 7 0 8 2 2 2 14 0 1
1 0 1 0 0 0 1 0 0 0 1 0 0 0 0 0 1 0 1 0 1 0 0 0 1 0 0 0 0 0 0 0 0 0 0 0 0 0 0 0 1
1 0 4 2 14 0 1 0 12 2 3 2 14 0 9 2 7 0 15 0 1 0 12 2 6 0 9 2 2 2 2 2 2 2 5 2 2 2 2 2 6
1 0 1 0 0 0 1 0 0 0 0 0 0 0 1 0 0 0 0 0 1 0 0 0 1 0 1 0 0 0 0 0 0 0 1 0 0 0 0 0 1
1 0 1 0 9 2 3 2 2 2 2 2 5 2 3 2 2 2 2 2 11 2 14 0 1 0 4 2 14 0 9 2 10 0 1 0 9 2 10 0 1
1 0 1 0 1 0 0 0 0 0 0 0 1 0 0 0 0 0 0 0 1 0 0 0 1 0 1 0 0 0 1 0 1 0 1 0 1 0 1 0 1
1 0 1 0 4 2 14 0 9 2 10 0 1 0 9 2 2 2 10 0 1 0 9 2 6 0 1 0 12 2 6 0 1 0 15 0 1 0 15 0 1
1 0 1 0 1 0 0 0 1 0 1 0 1 0 1 0 0 0 1 0 1 0 1 0 1 0 1 0 0 0 1 0 1 0 0 0 1 0 0 0 1
1 0 15 0 15 0 9 2 7 0 15 0 15 0 1 0 12 2 7 0 15 0 1 0 15 0 8 2 14 0 1 0 8 2 2 2 7 0 12 2 6
1 0 0 0 0 0 1 0 0 0 0 0 0 0 1 0 0 0 0 0 0 0 1 0 0 0 0 0 0 0 1 0 0 0 0 0 0 0 0 0 1
8 2 2 2 2 2 3 2 2 2 2 2 2 2 3 2 2 2 2 2 2 2 3 2 2 2 2 2 2 2 3 2 2 2 2 2 2 2 14 0 15
